border_size=1
usage=map

Gg          , Gg          , Gg          , Gg          , Gg          , Gg          , Gg          , Gg          , Gg          , Gg          , Gg          , Gg          , Gg          , Gg          , Gg          , Gg          , Hh          , Hh          , Hh          , Gg          , Hh          , Gg          
Gg          , Gg          , Gg          , Gg          , Gg          , Gg          , Gg          , Gg          , Gg          , Gg          , Gg          , Gg          , Gg          , Gg          , Gg          , Gg          , Gg          , Hh          , Gg          , Hh          , Hh          , Hh          
Gg          , Gg          , Gg          , Gg          , Gg          , Gg          , Gg          , Gg          , Gs^Fp       , Gg          , Gg          , Gg          , Gg          , Gg          , 3 Ke        , Gg          , Gg          , Gg          , Gg          , Hh^Vhh      , Hh          , Gg          
Gg          , Gg          , Gg          , Gg          , Ss          , Gg          , Gg          , Gs^Fp       , Gs^Fp       , Gs^Fp       , Gg          , Gg          , Gg          , Ce          , Ce          , Ce          , Ss          , Ss          , Ss          , Ss          , Gg          , Gg          
Gg          , Gg          , Gg          , Gg          , Gg          , Gg          , Gg          , Gs^Fp       , Gs^Fp       , Gs^Fp       , Ss          , Ss          , Ss          , Ss          , Gg          , Gg          , Gg          , Ss          , Ss          , Gs^Fp       , Gg          , Gg          
Gg          , Ss          , Ce          , 1 Ke        , Ce          , Gg          , Ggf         , Gg^Ve       , Gs^Fp       , Hh          , Hh          , Ss          , Gs^Fp       , Gs^Fp       , Ss          , Ss^Vhs      , Gs^Fp       , Ss          , Gs^Fp       , Gs^Fp       , Gg          , Gg          
Gg          , Ss          , Ss          , Ce          , Gg          , Gg          , Gg          , Gg          , Hh          , Hh          , Hh          , Gs^Fp       , Ss          , Gs^Fp       , Ss          , Gg          , Ss          , Gs^Fp       , Gg          , Gg          , Ggf         , Gg          
Ss          , Ss          , Gg          , Gg          , Ss          , Gg          , Gg          , Gg          , Gg          , Hh          , Gg^Fet      , Hh          , Ss          , Gs^Fp       , Ww          , Ss          , Ss          , Ww          , Ww          , Gg          , Gg          , Gg          
Gg          , Gg          , Ggf         , Gg          , Ss          , Gg          , Gg^Ve       , Ss          , Hh          , Hh          , Ss          , Ss          , Ss          , Ss          , Ss          , Ss          , Gs^Fp       , Ss          , Ww          , Ww          , Ww          , Ss          
Gg          , Hh          , Gg          , Gg          , Ss          , Gg          , Gs^Fp       , Ss          , Ss          , Ww          , Gg          , Ww          , Gg          , Gg          , Ss          , Gs^Fp       , Gs^Fp       , Gs^Fp       , Ss          , Ss          , Ww          , Ww          
Ss          , Ss          , Ww          , Ss          , Ww          , Ww          , Ww          , Ww          , Ww          , Gg          , Ss          , Gg          , Ss          , Ss          , Chr         , Ss          , Ss          , Ss          , Ww          , Ww          , Gg          , Gg          
Ww          , Ww          , Ww          , Ww          , Ww          , Ww          , Ss          , Gs^Fp       , Ss          , Ww          , Ss          , Ss          , Ss          , Ss          , Ww          , 4 Khr       , Ww          , Ww          , Ss          , Ss          , Gg          , Gg          
Ww          , Ww          , Ss          , Ww          , Ss          , Ss          , Ss          , Gg          , Ss          , Ww          , Ww          , Ww          , Ww          , Ww          , Ww          , Ww          , Ss          , Ss          , Ss          , Hh          , Hh          , Gg          
Gg          , Gg          , Ss          , Gg          , Ss          , Gg          , Ss          , Ss          , Gg          , Gg^Vh       , Gg          , Ss          , Gs^Fp       , Gs^Fp       , Ss          , Ss          , Ss          , Ss          , Ss          , Hh          , Hh          , Hh          
Gg          , Gg          , Gg          , Gg          , Gg          , Gg          , Ss          , Ss          , Ss          , Ggf         , Ss          , Ss          , Gg          , Ss          , Ggf         , Ss          , Gg          , Ss          , Gg          , Hh          , Hh          , Gg          
Ss          , Ss          , Gg          , Ss          , Gs^Fp       , Gs^Fp       , Gs^Fp       , Ss          , Re^Gvs      , Re^Gvs      , Re^Gvs      , Ss          , Ss          , Ggf         , Gg          , Gg          , Ss          , Gg          , Gg          , Hh          , Hh          , Gg          
Gg          , Ss          , Gg          , Ss          , Gs^Fp       , Gs^Fp       , Re^Gvs      , Re^Gvs      , Re^Gvs      , Re^Gvs      , Re^Gvs      , Ss          , Ggf         , Gg^Vh       , Ss          , Ss          , Ss          , Gg^Ve       , Gs^Fp       , Gs^Fp       , Gs^Fp       , Gg          
Gg          , Gg          , Gg          , Gg          , Gg          , Gg          , Re^Gvs      , Re^Gvs      , Re^Gvs      , Re^Gvs      , Ggf         , Ggf         , Ch          , Ss          , Ggf         , Ggf         , Ggf         , Gg          , Ss          , Gs^Fp       , Rp          , Rp          
Gg          , Gg          , Gg          , Gg^Wm       , Re^Gvs      , Re^Gvs      , Re^Gvs      , Re^Gvs      , Ss          , Ss          , Ss          , Ch          , 2 Kh        , Gg          , Ggf         , Ggf         , Ggf         , Gg          , Rp          , Rp          , Re^Gvs      , Re^Gvs      
Gg          , Gg^Ve       , Re^Gvs      , Re^Gvs      , Re^Gvs      , Re^Gvs      , Re^Gvs      , Ss          , Gg          , Gg          , Ggf         , Gg          , Gg          , Ch          , Rp          , Ggf         , Rp          , Rp          , Re^Gvs      , Re^Gvs      , Re^Gvs      , Re^Gvs      
Re^Gvs      , Re^Gvs      , Re^Gvs      , Re^Gvs      , Re^Gvs      , Re^Gvs      , Gg          , Gg          , Gg          , Gg          , Ggf         , Gg          , Ggf         , Rp          , Rp          , Rp          , Gg          , Re^Gvs      , Re^Gvs      , Re^Gvs      , Re^Gvs      , Re^Gvs      
Re^Gvs      , Re^Gvs      , Re^Gvs      , Re^Gvs      , Gg          , Gg          , Gg          , Gg          , Gg          , Gg          , Gg          , Ggf         , Rp          , Rp          , Gg          , Gg          , Gg          , Re^Gvs      , Re^Gvs      , Re^Gvs      , Re^Gvs      , Re^Gvs      
