border_size=1
usage=map

Mm^Xm       , Mm^Xm       , Mm^Xm       , Mm^Xm       , Mm^Xm       , Mm^Xm       , Mm^Xm       , Mm^Xm       , Mm^Xm       , Mm^Xm       , Mm^Xm       , Gg          , Mm^Xm       , Mm^Xm       , Mm^Xm       , Mm          , Mm^Xm       , Mm          , Mm^Xm       , Mm^Xm       , Mm^Xm       , Mm^Xm       , Mm^Xm       , Ss          , Wo          , Wo^Bw\      , Wo^Bw\      , Gs^Fp       , Wo          , Ww          , Ss          , Ss          , Ss          , Ss          , Wwf         , Ww          , Mm^Xm       , Mm^Xm       , Mm^Xm       , Ss          , Mm^Xm       , Mm^Xm       
Mm^Xm       , Mm^Xm       , Mm^Xm       , Mm^Xm       , Mm^Xm       , Mm^Xm       , Mm^Xm       , Mm^Xm       , Mm^Xm       , Mm^Xm       , Mm          , Mm^Xm       , Mm^Xm       , Mm^Xm       , Mm^Xm       , Mm^Xm       , Mm^Xm       , Mm^Xm       , Ww          , Mm^Xm       , Ss          , Mm^Xm       , Ss^Bw\      , Ss          , Wo          , Wo          , Wo          , Wo^Bw\      , Wo^Bw\      , Wo          , Chs         , Chs         , Chs         , Gg          , Wwf         , Wwf         , Hh          , Mm^Xm       , Mm^Xm       , Mm^Xm       , Mm^Xm       , Mm^Xm       
Mm^Xm       , Mm^Xm       , Mm^Xm       , Mm^Xm       , Mm^Xm       , Mm^Xm       , Hh          , Hh          , Hh          , Mm          , Mm          , Mm          , Mm^Xm       , Mm^Xm       , Rr          , Gg          , Gg          , Gg          , Ww          , Ch          , 5 Kh        , Ss          , Ss          , Ww^Bw/      , Ww          , Wo          , Ss          , Wo          , Wo          , Wo^Bw\      , Chs         , 4 Khs       , Chs         , Gg          , Ww          , Wwf         , Gg          , Hh          , Gg          , Mm^Xm       , Mm^Xm       , Mm^Xm       
Mm^Xm       , Mm^Xm       , Hh          , Mm^Xm       , Hh          , Hh          , Hh          , Hh          , Hh          , Hh          , Hh          , Mm^Xm       , Gg          , Gg          , Ss          , Rr          , Rr          , Gg^Ve       , Ww          , Ch          , Ch          , Ch          , Ww          , Ww          , Ss^Vhs      , Ss          , Ss          , Ss          , Ww          , Wo          , Wo          , Chs         , Wo          , Ss^Vhs      , Wo          , Ww          , Gg          , Hh          , Gg          , Mm^Xm       , Mm^Xm       , Mm^Xm       
Mm^Xm       , Hh          , Hh          , Hh          , Hh          , Hh          , Hh          , Hh          , Mm          , Mm^Xm       , Ss          , Ss          , Ss          , Ss^Vhs      , Ss          , Ss          , Ss          , Rr          , Ww          , Wwf         , Wwf         , Ss          , Ww          , Ss          , Ss          , Ss          , Gg          , Ww          , Ww          , Ww          , Wo          , Wo^Bw|      , Wo^Bw\      , Wo          , Ww          , Hh          , Gg          , Hh          , Gg          , Gg          , Mm^Xm       , Mm^Xm       
Mm^Xm       , Mm^Xm       , Mm          , Hh          , Mm          , Mm          , Mm          , Mm          , Ss          , Ss          , Ss          , Ss          , Chs         , Ss          , Ss          , Ss          , Ss          , Ww          , Ss          , Wwf         , Wwf         , Wwf         , Ww          , Ss^Vhs      , Ww          , Ss          , Ww          , Ww          , Gg          , Gs^Fp       , Gs^Fp       , Wo          , Ww          , Ww^Bw\      , Gg          , Ww          , Gg          , Hh          , Gs^Fp       , Gg          , Mm^Xm       , Mm^Xm       
Mm^Xm       , Mm^Xm       , Mm          , Mm          , Mm          , Mm          , Mm^Xm       , Mm^Xm       , Ss          , Ss          , Ss          , Chs         , 6 Khs       , Chs         , Ss          , Ss          , Ss          , Ss          , Ss          , Ww          , Wo          , Wwf         , Wwf         , Wwf         , Ww          , Wwf         , Wwf         , Gg^Ve       , Gg          , Gs^Fp       , Gs^Fp       , Gs^Fp       , Gs^Fp       , Ww          , Gg          , Hh          , Hh          , Hh          , Gs^Fp       , Gs^Fp       , Gg          , Mm^Xm       
Gg          , Gs^Fp       , Mm^Xm       , Mm          , Mm^Xm       , Mm^Xm       , Mm^Xm       , Ss          , Ww          , Ss          , Ww          , Ww          , Ww          , Ww          , Ww          , Ss          , Ss          , Ss          , Wo          , Wo          , Wo          , Ss          , Ss          , Wwf         , Wwf         , Ww          , Wwf         , Rr          , Rr          , Gg^Ve       , Gs^Fp       , Gs^Fp       , Gs^Fp       , Gg          , Gs^Fp       , Hh          , Gg          , Gg          , Gs^Fp       , Gg          , Rr          , Rr          
Gs^Fp       , Gs^Fp       , Mm^Xm       , Ss          , Ss          , Ss          , Ww          , Ww          , Ss          , Ww          , Ss          , Ss          , Ww          , Ww          , Gg          , Gg          , Wo          , Wo          , Wo          , Gg          , Ww          , Ww          , Ww          , Ww          , Ww          , Ww          , Gs^Fp       , Gs^Fp       , Gs^Fp       , Rr          , Gs^Fp       , Gg          , Gg          , Gs^Fp       , Gs^Fp       , Gg          , Gs^Fp       , Gs^Fp       , Rr          , Rr          , Gg          , Gg          
Mm^Xm       , Mm^Xm       , Gg          , Ss          , Ss          , Ww          , Ww          , Ss          , Ss          , Ss          , Ss          , Ss          , Wo          , Ww          , Wo          , Wo          , Wo          , Ss          , Ss          , Gg          , Ww          , Ww          , Ww          , Ww          , Ww          , Ww          , Gs^Fp       , Gs^Fp       , Gg          , Gs^Fp       , Rr          , Gs^Fp       , Gs^Fp       , Gs^Fp       , Gs^Fp       , Gs^Fp       , Gg          , Gg^Ve       , Rr          , Gg          , Gg          , Gg          
Gg          , Gg          , Ss          , Ss          , Wo          , Wo          , Ss          , Ss          , Ss          , Ss          , Ss          , Ss          , Ww          , Wo          , Wo          , Wo          , Ss          , Ss          , Ss          , Ww          , Ss          , Ww          , Ww          , Gs^Fp       , Gs^Fp       , Gs^Fp       , Gs^Fp       , Gs^Fp       , Gs^Fp       , Gs^Fp       , Rr          , Gs^Fp       , Gs^Fp       , Gs^Fp       , Gs^Fp       , Gg          , Rr          , Rr          , Gg          , Gg          , Gg          , Gg          
Ss          , Ss          , Ss          , Wo          , Wo          , Ss          , Ss          , Ss          , Ss          , Ss          , Ss          , Ss          , Ww          , Ss          , Ss          , Ss          , Ss          , Ss          , Ww          , Ww          , Ss          , Gg          , Gg          , Ww          , Gg          , Gs^Fp       , Gg          , Gs^Fp       , Gs^Fp       , Gs^Fp       , Gs^Fp       , Gs^Fp       , Gs^Fp       , Gs^Fp       , Gg          , Rr          , Gg          , Gg          , Gg          , Gg          , Gs^Fp       , Gg          
Ss          , Ss          , Ss          , Wo          , Ss          , Ss          , Ww          , Ww          , Ww          , Ss          , Ww          , Ww          , Ss          , Ss          , Ss          , Ss          , Ww          , Ww          , Ss          , Ss          , Ss          , Gg          , Gg          , Ww          , Ww          , Gs^Fp       , Gs^Fp       , Gs^Fp       , Gs^Fp       , Gs^Fp       , Gs^Fp       , Gg          , Gg          , Gs^Fp       , Gg          , Rr          , Gg          , Gg          , Gg          , Gs^Fp       , Gg          , Gg          
Ss          , Ss          , Wo          , Wo          , Ww          , Ww          , Gg          , Ss          , Gg          , Ww          , Chs         , Chs         , Chs         , Ss          , Ww          , Ww          , Ww          , Ss          , Ss          , Ss          , Gg          , Gg          , Gg          , Gg          , Gg          , Ww          , Ww          , Gg          , Gs^Fp       , Gs^Fp       , Rr          , Gg          , Gs^Fp       , Gs^Fp       , Rr          , Rr          , Gg          , Gg^Ve       , Gs^Fp       , Gs^Fp       , Gg          , Gg          
Ww          , Ss          , Ww          , Ww          , Ss^Vhs      , Ss          , Gg          , Gg          , Gg          , Ss          , Chs         , 3 Khs       , Chs         , Ww          , Ww          , Ww          , Ss          , Ss          , Gg          , Gg          , Gg          , Gg          , Gg          , Gg          , Gg          , Gg          , Ww          , Ww          , Ww          , Gs^Fp       , Rr          , Gg          , Rr          , Rr          , Gg          , Gg          , Gs^Fp       , Gg          , Gs^Fp       , Gs^Fp       , Gg          , Gg          
Ss          , Ww          , Ss          , Ss          , Gg          , Gg          , Gg          , Gg^Ve       , Gg          , Ss          , Hh          , Chs         , Gg          , Ss          , Gg          , Ss          , Gg          , Gg          , Gg          , Gg          , Gs^Fp       , Gg          , Gg          , Gg          , Gg          , Gg          , Gg          , Ww          , Ww          , Gg          , Rr          , Rr          , Gg          , Gg          , Gs^Fp       , Gs^Fp       , Gg          , Gs^Fp       , Gg          , Gg          , Gg          , Gg          
Ss          , Ss          , Gg          , Gg          , Gs^Fp       , Gg          , Gg          , Gg          , Gg          , Gg          , Ss          , Gg          , Gg          , Gg          , Ss          , Ss          , Gs^Fp       , Gs^Fp       , Gs^Fp       , Gs^Fp       , Gg          , Gg          , Gg          , Gg          , Gg          , Gg          , Gg          , Ww          , Ww^Bw/      , Ww^Bw/      , Gg          , Gg          , Gg          , Gs^Fp       , Gs^Fp       , Gs^Fp       , Gg          , Gs^Fp       , Gs^Fp       , Gg          , Gg          , Gg          
Gs^Fp       , Gs^Fp       , Gs^Fp       , Gs^Fp       , Gs^Fp       , Gs^Fp       , Gs^Fp       , Gg          , Gg          , Gg          , Gg          , Gg^Ve       , Gs^Fp       , Ss          , Ss          , Gs^Fp       , Gs^Fp       , Gs^Fp       , Gs^Fp       , Gs^Fp       , Hh          , Hh          , Hh          , Hh          , Hh          , Gg          , Hh          , Rr          , Gg          , Ww          , Ww          , Gg          , Gg          , Gg          , Gg          , Gs^Fp       , Gg          , Gg          , Gs^Fp       , Gg          , Gg          , Gg          
Gg          , Gg          , Gs^Fp       , Gs^Fp       , Gs^Fp       , Gs^Fp       , Gg          , Gg          , Gg          , Gg          , Ss          , Ss          , Ss          , Ss          , Ss          , Gs^Fp       , Gg          , Gs^Fp       , Gg^Vh       , Gg          , Hh          , Hh          , Hh          , Hh          , Mm          , Hh          , Hh          , Rr          , Hh          , Gg          , Gg          , Ww          , Gg          , Gg          , Gg          , Gs^Fp       , Gg          , Gg          , Gg          , Gs^Fp       , Gg          , Gg          
Gg          , Gs^Fp       , Gg          , Gg          , Gg          , Gg          , Gg          , Gg          , Gg          , Gg          , Ss          , Ss          , Ss          , Ss          , Gg          , Gg          , Gg          , Gg          , Hh          , Hh          , Hh          , Hh          , Hh          , Mm          , Mm          , Mm          , Rr          , Rr          , Gg          , Hh          , Gg          , Ww          , Ww          , Gg          , Gg          , Gg          , Gg          , Gg          , Gs^Fp       , Gs^Fp       , Gs^Fp       , Gg          
Gg          , Gg          , Gg          , Gg          , Gs^Fp       , Gg          , Gg          , Gg          , Gg          , Gg          , Gs^Fp       , Gg          , Gg          , Gg          , Gg          , Gg          , Gg          , Hh          , Hh          , Hh          , Mm          , Mm          , Hh          , Mm          , Rr          , Rr          , Hh^Vhh      , Hh          , Mm          , Hh          , Gg          , Gg          , Ww          , Gg          , Gg          , Gg          , Gg          , Gg          , Gs^Fp       , Gg          , Gg          , Gg          
Gg          , Gg          , Gs^Fp       , Gs^Fp       , Gg          , Gg          , Gg          , Gg          , Gg          , Gs^Fp       , Gg          , Gs^Fp       , Gs^Fp       , Gs^Fp       , Gg          , Gg          , Gg          , Hh          , Hh          , Hh          , Mm          , Mm          , Mm          , Rr          , Hh          , Hh          , Mm          , Hh          , Hh          , Hh          , Hh          , Gg          , Gg          , Ww          , Gg          , Gg          , Gg          , Gg          , Gs^Fp       , Gs^Fp       , Gg          , Gg          
Re^Gvs      , Gg          , Gg          , Gs^Fp       , Gg          , Gg          , Gg          , Gg          , Re^Gvs      , Re^Gvs      , Re^Gvs      , Gg          , Gg          , Gg          , Gg          , Gg          , Gg          , Gg          , Gg          , Hh          , Hh          , Mm          , Rr          , Rr          , Mm          , Mm          , Mm          , Mm          , Hh          , Hh          , Hh          , Gg          , Gg          , Ww          , Gg          , Gg^Ve       , Mm          , Gs^Fp       , Gs^Fp       , Gs^Fp       , Gg          , Gg          
Re^Gvs      , Re^Gvs      , Re^Gvs      , Gs^Fp       , Gs^Fp       , Gg          , Re^Gvs      , Re^Gvs      , Re^Gvs      , Re^Gvs      , Re^Gvs      , Gg          , Ce          , Ce          , Ce          , Gg          , Gg          , Gg^Ve       , Gg          , Gg          , Rr          , Rr          , Hh          , Hh          , Hh          , Mm          , Hh          , Hh          , Gg          , Hh          , Hh          , Gg          , Gg          , Ww          , Gg          , Mm          , Mm          , Gs^Fp       , Gs^Fp       , Gs^Fp       , Gg          , Gg          
Re^Gvs      , Re^Gvs      , Re^Gvs      , Gg          , Gg          , Gg          , Re^Gvs      , Re^Gvs      , Re^Gvs      , Re^Gvs      , Gg          , Gg          , Ce          , 1 Ke        , Ce          , Gg          , Gg          , Gg          , Rr          , Rr          , Gg          , Hh          , Hh          , Hh          , Hh          , Hh          , Hh          , Gg          , Hh          , Hh          , Re^Gvs      , Re^Gvs      , Re^Gvs      , Ww          , Ww          , Gg          , Gg          , Mm          , Gg          , Gs^Fp       , Gg          , Gg          
Re^Gvs      , Re^Gvs      , Re^Gvs      , Re^Gvs      , Gg          , Gg          , Rr          , Re^Gvs      , Rr          , Rr          , Rr          , Rr          , Rr          , Ce          , Rr          , Rr          , Rr          , Rr          , Re^Gvs      , Re^Gvs      , Re^Gvs      , Hh          , Hh          , Hh          , Hh          , Hh          , Hh          , Hh          , Re^Gvs      , Re^Gvs      , Re^Gvs      , Re^Gvs      , Re^Gvs      , Re^Gvs      , Gg          , Ww          , Gg          , Gg          , Ce          , Gg^Ve       , Gg          , Gg          
Gg          , Re^Gvs      , Re^Gvs      , Re^Gvs      , Rr          , Rr          , Gg          , Rr          , Gg          , Gg          , Gg          , Gg          , Gg          , Rr          , Gg          , Gg^Ve       , Gg          , Gg          , Re^Gvs      , Re^Gvs      , Re^Gvs      , Gg          , Gg          , Hh^Vhh      , Hh          , Hh          , Gg          , Gg          , Re^Gvs      , Re^Gvs      , Re^Gvs      , Re^Gvs      , Re^Gvs      , Re^Gvs      , Gg^Ve       , Ww          , Ww          , Ce          , 2 Ke        , Ce          , Gg          , Gg          
Rr          , Gg          , Rr          , Rr          , Gg          , Gg          , Gg          , Gg^Ve       , Gg          , Gg          , Gg          , Gg          , Gg          , Gg          , Gg          , Gg          , Gg          , Gg          , Gs^Fp       , Re^Gvs      , Gs^Fp       , Gg          , Gg          , Gg          , Mm          , Mm          , Mm          , Mm          , Gg          , Re^Gvs      , Re^Gvs      , Re^Gvs      , Mm          , Gg          , Gg          , Gg          , Ww^Bw/      , Ce          , Ce          , Ce          , Gg          , Gg          
Gs^Fp       , Rp          , Gs^Fp       , Gs^Fp       , Gs^Fp       , Gg          , Gg          , Gg          , Gg          , Gg          , Gg          , Gg          , Gg          , Gg          , Gs^Fp       , Gg          , Gs^Fp       , Gs^Fp       , Gg          , Gg          , Gg          , Gg          , Gg          , Gg          , Gg          , Mm          , Gg          , Gg          , Gg          , Gg          , Gs^Fp       , Gs^Fp       , Gs^Fp       , Mm          , Mm          , Gg          , Gg          , Ww          , Gg          , Gg          , Gg          , Gg          
Gs^Fp       , Gs^Fp       , Gg          , Gg          , Gg          , Gs^Fp       , Gg          , Gg          , Gg          , Gg          , Gs^Fp       , Gs^Fp       , Gg          , Gg          , Gs^Fp       , Gs^Fp       , Gg          , Gg          , Gg          , Gg          , Gg          , Gg          , Gg          , Gg          , Gg          , Gg          , Gg          , Gg          , Gg          , Gg          , Gs^Fp       , Gs^Fp       , Gs^Fp       , Gs^Fp       , Mm          , Gg          , Gg          , Ww          , Ww          , Gg          , Gg          , Gg          
Gg          , Gg          , Gg          , Gg          , Gg          , Gg          , Gg          , Gs^Fp       , Gg          , Gs^Fp       , Gg          , Gg          , Gg          , Gg          , Gg          , Gg          , Ss          , Gg          , Gg          , Gg          , Gg          , Gg          , Gg          , Gg          , Gg          , Gg          , Gg          , Gg          , Gg          , Gg          , Gg          , Gs^Fp       , Gg          , Gg          , Gg          , Gg          , Gg          , Gg          , Ww          , Gg          , Gg          , Gg          
