border_size=1
usage=map

Gs^Fp       , Gs^Fp       , Gs^Fp       , Gs^Fp       , Gg          , Gg          , Gg          , Qlf         , Qlf         , Ql          , Ql          , Ql          
Gs^Fp       , Gs^Fp       , Gs^Fp       , Gs^Fp       , Gs^Fp       , Gg          , Gg          , Qlf         , Qlf         , Ql          , Ql          , Gg          
Gs^Fp       , Gs^Fp       , Gs^Fp       , Gs^Fp       , Gs^Fp       , Gg          , Gg          , Qlf         , Qlf         , Qxu         , Qxu         , Ql          
Gs^Fp       , Gs^Fp       , Gs^Fp       , Gs^Fp       , Gs^Fp       , Gs^Fp       , Gg          , Gg          , Uh          , Qxu         , Qxu         , Ql          
Gs^Fp       , Gs^Fp       , Gs^Fp       , Gs^Fp       , Gs^Fp       , Gg          , Gg          , Gg          , Uh          , Qlf         , Qxu         , Ql          
Gs^Fp       , Gs^Fp       , Gs^Fp       , Gs^Fp       , Gg          , Gg          , Ww          , Qlf         , Qlf         , Qlf         , Qlf         , Ql          
Ww          , Gs^Fp       , Ww          , Ww          , Ww          , Ww          , Kh          , Gg          , Gg          , Qxu         , Qxu         , Qlf         
Gs^Fp       , Ww          , Gg          , Gg          , Rr          , Rr          , Gg          , Rr          , Rr          , Uh          , Uh          , Qxu         
Gs^Fp       , Gg          , Gg          , Kv          , Gg          , Gg          , Gg          , Gg          , Gg          , Kud         , Uh          , Qxu         
Gs^Fp       , Gs^Fp       , Gs^Fp       , Gg          , Gg          , Gg          , Gg          , Gg          , Uh          , Uh          , Uh          , Qxu         
Gs^Fp       , Gs^Fp       , Gs^Fp       , Gg          , Gg          , Gg          , Gg          , Gg          , Uh          , Qlf         , Qxu         , Qxu         
Gs^Fp       , Gs^Fp       , Gs^Fp       , Gs^Fp       , Gs^Fp       , Gg          , Gg          , Gg          , Qlf         , Qlf         , Ql          , Ql          
